{
	"name":"Maze 001",
	"size":40,
	"map":[
		[
			["1", "1", "1", "1", "1", "1", "1", "1", "1", "1"],
			["1", "9", "9", "9", "9", "9", "9", "9", "9", "1"],
			["1", "9", "9", "9", "9", "9", "9", "9", "9", "1"],
			["1", "9", "9", "9", "9", "9", "9", "9", "9", "1"],
			["1", "9", "9", "9", "9", "9", "9", "9", "9", "1"],
			["1", "9", "9", "9", "9", "9", "9", "9", "9", "1"],
			["1", "9", "9", "9", "9", "9", "9", "9", "9", "1"],
			["1", "9", "9", "9", "9", "9", "9", "9", "9", "1"],
			["1", "9", "9", "9", "9", "9", "9", "9", "9", "1"],
			["1", "S", "1", "1", "1", "1", "1", "1", "1", "1"]
		],
		[
			["1", "1", "1", "1", "1", "1", "1", "1", "1", "1"],
			["1", "8", "8", "8", "8", "8", "8", "8", "9", "1"],
			["1", "8", "8", "8", "8", "8", "8", "8", "8", "1"],
			["1", "8", "8", "8", "8", "8", "8", "8", "8", "1"],
			["1", "8", "8", "8", "8", "8", "8", "8", "8", "1"],
			["1", "8", "8", "8", "8", "8", "8", "8", "8", "1"],
			["1", "8", "8", "8", "8", "8", "8", "8", "8", "1"],
			["1", "8", "8", "8", "8", "8", "8", "8", "8", "1"],
			["1", "8", "8", "8", "8", "8", "8", "8", "8", "1"],
			["9", "8", "8", "8", "8", "8", "8", "8", "8", "1"]
		],
		[
			["1", "1", "1", "1", "1", "1", "1", "1", "1", "1"],
			["1", "9", "9", "9", "9", "9", "9", "9", "9", "1"],
			["1", "9", "9", "9", "9", "9", "9", "9", "9", "1"],
			["1", "9", "9", "9", "9", "9", "9", "9", "9", "1"],
			["1", "9", "9", "9", "9", "9", "9", "9", "9", "1"],
			["1", "9", "9", "9", "9", "9", "9", "9", "9", "1"],
			["1", "9", "9", "9", "9", "9", "9", "9", "9", "1"],
			["1", "9", "9", "9", "9", "9", "9", "9", "9", "1"],
			["9", "9", "9", "9", "9", "9", "9", "9", "9", "1"],
			["9", "9", "9", "9", "9", "9", "9", "9", "9", "1"]
		],
		[
			["1", "1", "1", "1", "1", "1", "1", "1", "1", "1"],
			["1", "9", "9", "9", "9", "9", "9", "9", "9", "1"],
			["1", "9", "9", "9", "9", "9", "9", "9", "9", "1"],
			["1", "9", "9", "9", "9", "9", "9", "9", "9", "1"],
			["1", "9", "9", "9", "9", "9", "9", "9", "9", "1"],
			["1", "9", "9", "9", "9", "9", "9", "9", "9", "1"],
			["1", "9", "9", "9", "9", "9", "9", "9", "9", "1"],
			["9", "9", "9", "9", "9", "9", "9", "9", "9", "1"],
			["9", "9", "9", "9", "9", "9", "9", "9", "9", "1"],
			["9", "9", "9", "9", "9", "9", "9", "9", "9", "1"]
		],
		[
			["1", "1", "1", "1", "1", "1", "1", "1", "1", "1"],
			["1", "9", "9", "9", "9", "9", "9", "9", "9", "1"],
			["1", "9", "9", "9", "9", "9", "9", "9", "9", "1"],
			["1", "9", "9", "9", "9", "9", "9", "9", "9", "1"],
			["1", "9", "9", "9", "9", "9", "9", "9", "9", "1"],
			["1", "9", "9", "9", "9", "9", "9", "9", "9", "1"],
			["9", "9", "9", "9", "9", "9", "9", "9", "9", "1"],
			["9", "9", "9", "9", "9", "9", "9", "9", "9", "1"],
			["9", "9", "9", "9", "9", "9", "9", "9", "9", "1"],
			["9", "9", "9", "9", "9", "9", "9", "9", "9", "1"]
		],
		[
			["1", "1", "1", "1", "1", "1", "1", "1", "1", "1"],
			["1", "9", "9", "9", "9", "9", "9", "9", "9", "1"],
			["1", "9", "9", "9", "9", "9", "9", "9", "9", "1"],
			["1", "9", "9", "9", "9", "9", "9", "9", "9", "1"],
			["1", "9", "9", "9", "9", "9", "9", "9", "9", "1"],
			["9", "9", "9", "9", "9", "9", "9", "9", "9", "1"],
			["9", "9", "9", "9", "9", "9", "9", "9", "9", "1"],
			["9", "9", "9", "9", "9", "9", "9", "9", "9", "1"],
			["9", "9", "9", "9", "9", "9", "9", "9", "9", "1"],
			["9", "9", "9", "9", "9", "9", "9", "9", "9", "1"]
		]
	]
	
}